;Wegvoertuigen per 1 januari|Totaal wegvoertuigen;Wegvoertuigen per 1 januari|Personenauto;Wegvoertuigen per 1 januari|Bedrijfsvoertuigen|Totaal bedrijfsvoertuigen;Wegvoertuigen per 1 januari|Bedrijfsvoertuigen|Bedrijfsmotorvoertuigen|Totaal bedrijfsmotorvoertuigen;Wegvoertuigen per 1 januari|Bedrijfsvoertuigen|Bedrijfsmotorvoertuigen|Bestelauto;Wegvoertuigen per 1 januari|Bedrijfsvoertuigen|Bedrijfsmotorvoertuigen|Vrachtauto (excl. trekker voor oplegger);Wegvoertuigen per 1 januari|Bedrijfsvoertuigen|Bedrijfsmotorvoertuigen|Trekker voor oplegger;Wegvoertuigen per 1 januari|Bedrijfsvoertuigen|Bedrijfsmotorvoertuigen|Speciaal voertuig;Wegvoertuigen per 1 januari|Bedrijfsvoertuigen|Bedrijfsmotorvoertuigen|Bus;Wegvoertuigen per 1 januari|Bedrijfsvoertuigen|Aanhangwagens en opleggers|Totaal aanhangwagens en opleggers;Wegvoertuigen per 1 januari|Bedrijfsvoertuigen|Aanhangwagens en opleggers|Aanhangwagen;Wegvoertuigen per 1 januari|Bedrijfsvoertuigen|Aanhangwagens en opleggers|Oplegger;Wegvoertuigen per 1 januari|Motorfiets;Wegvoertuigen per 1 januari|Voertuigen met bromfietskenteken|Alle voertuigen met bromfietskenteken;Wegvoertuigen per 1 januari|Voertuigen met bromfietskenteken|Snorfiets;Wegvoertuigen per 1 januari|Voertuigen met bromfietskenteken|Bromfiets;Wegvoertuigen per 1 januari|Voertuigen met bromfietskenteken|Brommobiel;Wegvoertuigen per 1 januari|Voertuigen met bromfietskenteken|Overige voertuigen met bromfietskenteken
Aa en Hunze;23265;14645;5363;2020;1646;97;119;157;1;3343;3168;175;1758;1499;656;793;37;13
Aalburg;0;0;0;0;0;0;0;0;0;0;0;0;0;0;0;0;0;0
Aalsmeer;26641;17011;4630;2390;1908;239;153;60;30;2240;1996;244;1493;3507;1688;1769;35;15
Aalten;21465;14193;4440;1870;1602;101;69;96;2;2570;2465;105;1433;1399;690;668;34;7
Ter Aar;0;0;0;0;0;0;0;0;0;0;0;0;0;0;0;0;0;0
Abcoude;0;0;0;0;0;0;0;0;0;0;0;0;0;0;0;0;0;0
Achtkarspelen;25277;14873;6338;2835;2293;166;149;186;41;3503;3319;184;1231;2835;1328;1439;59;9
Akersloot;0;0;0;0;0;0;0;0;0;0;0;0;0;0;0;0;0;0
Alblasserdam;14024;9129;3235;1606;1053;102;384;35;32;1629;1102;527;559;1101;562;520;14;5
Albrandswaard;17709;12552;2409;1033;759;63;130;76;5;1376;1260;116;956;1792;1072;692;18;10
Alkemade;0;0;0;0;0;0;0;0;0;0;0;0;0;0;0;0;0;0
Alkmaar;75052;49280;11822;6532;4911;466;352;771;32;5290;4793;497;4530;9420;5851;3426;110;33
Almelo;52102;34268;10136;4639;3790;199;415;231;4;5497;4452;1045;2432;5266;3819;1350;81;16
Almere;335268;270553;42602;35968;34576;686;300;380;26;6634;6290;344;7237;14876;11052;3693;84;47
Alphen aan den Rijn;81832;52667;15677;7328;5945;518;579;260;26;8349;7194;1155;4696;8792;5245;3410;89;48
Alphen-Chaam;9612;6124;2153;990;851;53;34;48;4;1163;1122;41;643;692;285;392;13;2
Altena;48179;29363;12273;5840;4451;436;651;270;32;6433;5597;836;2237;4306;2130;2052;107;17
Ambt Delden;0;0;0;0;0;0;0;0;0;0;0;0;0;0;0;0;0;0
Ambt Montfort;0;0;0;0;0;0;0;0;0;0;0;0;0;0;0;0;0;0
Ameland;3470;1843;764;442;381;32;16;13;0;322;297;25;299;564;361;186;14;3
Amerongen;0;0;0;0;0;0;0;0;0;0;0;0;0;0;0;0;0;0
Amersfoort;148230;108632;22530;16596;14728;342;241;431;854;5934;5630;304;5523;11545;8702;2690;109;44
Amstelveen;49747;37957;3770;1977;1705;103;43;112;14;1793;1743;50;2132;5888;3461;2364;44;19
Amsterdam;342803;235026;34482;23999;20912;1027;675;1076;309;10483;9397;1086;19419;53876;34941;18097;411;427
Andijk;0;0;0;0;0;0;0;0;0;0;0;0;0;0;0;0;0;0
Angerlo;0;0;0;0;0;0;0;0;0;0;0;0;0;0;0;0;0;0
Anna Paulowna;0;0;0;0;0;0;0;0;0;0;0;0;0;0;0;0;0;0
Apeldoorn;126155;83415;22520;10723;8217;984;602;834;86;11797;10912;885;6982;13238;10241;2790;154;53
Appingedam;7828;5522;1098;406;354;6;13;33;0;692;685;7;559;649;331;301;17;0
Arcen en Velden;0;0;0;0;0;0;0;0;0;0;0;0;0;0;0;0;0;0
Arnhem;92397;64950;10734;5905;4361;647;165;726;6;4829;4641;188;4288;12425;9213;3037;126;49
Assen;48046;32884;7612;3087;2408;151;198;278;52;4525;4263;262;3388;4162;2723;1373;52;14
Asten;14676;9038;3915;1816;1355;104;285;71;1;2099;1648;451;692;1031;602;405;21;3
Avereest;0;0;0;0;0;0;0;0;0;0;0;0;0;0;0;0;0;0
Axel;0;0;0;0;0;0;0;0;0;0;0;0;0;0;0;0;0;0
Baarle-Nassau;6711;4186;1644;801;661;38;58;40;4;843;780;63;341;540;308;219;11;2
Baarn;17006;12263;2156;1046;934;28;20;56;8;1110;1089;21;977;1610;922;644;34;10
Barendrecht;35543;23376;6719;3211;2291;286;549;83;2;3508;2364;1144;1582;3866;2316;1512;28;10
Barneveld;49664;28795;14617;6957;5307;387;896;328;39;7660;6148;1512;2627;3625;1884;1582;134;25
Bathmen;0;0;0;0;0;0;0;0;0;0;0;0;0;0;0;0;0;0
Bedum;0;0;0;0;0;0;0;0;0;0;0;0;0;0;0;0;0;0
Beek (L.);13456;9553;1990;926;744;65;60;55;2;1064;977;87;781;1132;667;438;18;9
Beekdaelen;31585;21646;5148;2306;1923;158;114;109;2;2842;2659;183;1898;2893;1653;1157;65;18
Beemster;9074;5160;2474;1117;895;81;91;50;0;1357;1236;121;565;875;368;484;15;8
Beesel;10066;7089;1678;675;523;37;75;39;1;1003;925;78;552;747;391;333;22;1
Belfeld;0;0;0;0;0;0;0;0;0;0;0;0;0;0;0;0;0;0
Bellingwedde;0;0;0;0;0;0;0;0;0;0;0;0;0;0;0;0;0;0
Berg en Dal;27067;18115;4013;1909;1648;67;62;124;8;2104;2049;55;1423;3516;2024;1439;47;6
Bemmel;0;0;0;0;0;0;0;0;0;0;0;0;0;0;0;0;0;0
Bennebroek;0;0;0;0;0;0;0;0;0;0;0;0;0;0;0;0;0;0
Bergambacht;0;0;0;0;0;0;0;0;0;0;0;0;0;0;0;0;0;0
Bergeijk;18213;10743;4423;1974;1683;77;98;95;21;2449;2281;168;1145;1902;1099;758;27;18
Bergen (L.);12321;7803;2810;1125;839;47;168;70;1;1685;1522;163;726;982;433;519;22;8
Bergen (NH.);23551;15933;3430;1660;1397;78;27;156;2;1770;1751;19;1506;2682;1580;1056;27;19
Bergen op Zoom;47037;32257;8018;3377;2574;251;312;201;39;4641;3770;871;2307;4455;3109;1247;75;24
Bergh;0;0;0;0;0;0;0;0;0;0;0;0;0;0;0;0;0;0
Bergschenhoek;0;0;0;0;0;0;0;0;0;0;0;0;0;0;0;0;0;0
Berkel en Rodenrijs;0;0;0;0;0;0;0;0;0;0;0;0;0;0;0;0;0;0
Berkelland;37567;24587;8387;3345;2793;175;204;167;6;5042;4774;268;2392;2201;942;1198;49;12
Bernheze;27771;16550;7207;3300;2737;211;173;175;4;3907;3691;216;1616;2398;1412;920;48;18
Bernisse;0;0;0;0;0;0;0;0;0;0;0;0;0;0;0;0;0;0
Best;22405;15288;3713;1592;1298;123;92;78;1;2121;1997;124;1169;2235;1624;583;18;10
Beuningen;20286;13853;3381;1476;1170;105;100;101;0;1905;1764;141;1095;1957;1477;445;24;11
Beverwijk;30276;18996;5807;2765;1961;277;405;117;5;3042;2132;910;1659;3814;2418;1330;53;13
het Bildt;0;0;0;0;0;0;0;0;0;0;0;0;0;0;0;0;0;0
De Bilt;29897;21129;4784;2179;1694;100;218;159;8;2605;2347;258;1465;2519;1270;1197;38;14
Binnenmaas;0;0;0;0;0;0;0;0;0;0;0;0;0;0;0;0;0;0
Bladel;19356;11525;4886;2279;1758;146;251;121;3;2607;2217;390;1206;1739;1009;694;31;5
Blaricum;8780;6578;943;451;338;32;7;74;0;492;480;12;375;884;478;395;7;4
Bleiswijk;0;0;0;0;0;0;0;0;0;0;0;0;0;0;0;0;0;0
Bloemendaal;15579;12233;1170;502;437;12;10;43;0;668;664;4;762;1414;977;420;9;8
Boarnsterhim;0;0;0;0;0;0;0;0;0;0;0;0;0;0;0;0;0;0
Bodegraven;0;0;0;0;0;0;0;0;0;0;0;0;0;0;0;0;0;0
Bodegraven-Reeuwijk;27632;16901;6665;3131;2407;247;370;88;19;3534;2983;551;1611;2455;1226;1184;26;19
Boekel;10286;5810;2517;1228;1024;55;64;85;0;1289;1201;88;828;1131;684;432;11;4
Ten Boer;0;0;0;0;0;0;0;0;0;0;0;0;0;0;0;0;0;0
Bolsward;0;0;0;0;0;0;0;0;0;0;0;0;0;0;0;0;0;0
Borculo;0;0;0;0;0;0;0;0;0;0;0;0;0;0;0;0;0;0
Borger-Odoorn;25236;15313;6399;2622;2191;130;140;158;3;3777;3665;112;1708;1816;762;985;56;13
Born;0;0;0;0;0;0;0;0;0;0;0;0;0;0;0;0;0;0
Borne;17419;11811;3223;1239;1009;53;92;79;6;1984;1947;37;1064;1321;812;488;17;4
Borsele;22025;12973;5621;2737;2168;131;267;118;53;2884;2503;381;1422;2009;869;1091;39;10
Boskoop;0;0;0;0;0;0;0;0;0;0;0;0;0;0;0;0;0;0
Boxmeer;24152;15806;5299;2285;1636;160;361;125;3;3014;2498;516;1378;1669;807;807;52;3
Boxtel;23582;14957;5091;2380;1808;136;229;198;9;2711;2317;394;1231;2303;1412;838;48;5
Breda;190752;149868;24186;15766;14093;402;795;460;16;8420;7332;1088;5842;10856;6003;4651;154;48
Brederwiede;0;0;0;0;0;0;0;0;0;0;0;0;0;0;0;0;0;0
Breukelen;0;0;0;0;0;0;0;0;0;0;0;0;0;0;0;0;0;0
Brielle;14515;9617;2557;1197;904;46;95;152;0;1360;1200;160;785;1556;812;719;16;9
Broekhuizen;0;0;0;0;0;0;0;0;0;0;0;0;0;0;0;0;0;0
Bronckhorst;35425;21448;8702;3830;3153;145;336;195;1;4872;4560;312;2713;2562;1255;1271;26;10
Brummen;17192;11270;3624;1362;1114;62;112;73;1;2262;1856;406;1076;1222;652;547;16;7
Brunssum;21594;15387;2389;1158;976;49;36;88;9;1231;1173;58;1346;2472;1548;846;67;11
Bunnik;10649;7230;2050;919;767;35;42;62;13;1131;1079;52;533;836;409;405;16;6
Bunschoten;15624;9636;3550;1804;1417;196;121;70;0;1746;1563;183;555;1883;1429;424;20;10
Buren;26642;15720;7116;3360;2480;280;427;173;0;3756;3221;535;1498;2308;992;1235;61;20
Bussum;0;0;0;0;0;0;0;0;0;0;0;0;0;0;0;0;0;0
Capelle aan den IJssel;42532;31012;4857;2575;2346;103;52;72;2;2282;2203;79;1842;4821;3041;1704;57;19
Castricum;26350;17344;4901;2088;1505;121;339;123;0;2813;2240;573;1858;2247;1369;839;26;13
Coevorden;31642;19426;7411;2966;2495;120;185;165;1;4445;4054;391;2431;2374;1273;1042;47;12
Cranendonck;18606;11958;4030;1853;1566;98;91;97;1;2177;2024;153;1138;1480;916;521;35;8
Cromstrijen;0;0;0;0;0;0;0;0;0;0;0;0;0;0;0;0;0;0
Cuijk;20251;13397;4286;1991;1323;325;215;118;10;2295;1902;393;1053;1515;861;611;41;2
Culemborg;18682;13269;3099;1495;1145;170;118;59;3;1604;1467;137;960;1354;732;592;27;3
Dalfsen;28560;16289;8347;3219;2421;200;353;147;98;5128;4533;595;2242;1682;619;1015;38;10
Dantumadeel;0;0;0;0;0;0;0;0;0;0;0;0;0;0;0;0;0;0
Dantumadiel;16120;9914;3695;1657;1412;65;49;120;11;2038;1970;68;835;1676;786;840;43;7
Delft;48623;33065;5498;3023;2308;197;360;157;1;2475;1963;512;2462;7598;4497;3009;65;27
Delfzijl;18913;12506;3650;1502;1262;45;92;101;2;2148;2007;141;1271;1486;736;672;65;13
Denekamp;0;0;0;0;0;0;0;0;0;0;0;0;0;0;0;0;0;0
Deurne;28466;17121;6877;3284;2570;211;311;171;21;3593;2976;617;1577;2891;1725;1106;47;13
Deventer;65009;44156;10281;4605;3225;192;235;274;679;5676;4990;686;3443;7129;5523;1503;84;19
Didam;0;0;0;0;0;0;0;0;0;0;0;0;0;0;0;0;0;0
Diemen;15432;10108;1860;1133;889;65;32;89;58;727;647;80;874;2590;1790;787;9;4
Diepenheim;0;0;0;0;0;0;0;0;0;0;0;0;0;0;0;0;0;0
Dinkelland;24188;14556;6209;2868;2352;185;224;86;21;3341;3058;283;1260;2163;1297;837;21;8
Dinxperlo;0;0;0;0;0;0;0;0;0;0;0;0;0;0;0;0;0;0
Dirksland;0;0;0;0;0;0;0;0;0;0;0;0;0;0;0;0;0;0
Dodewaard;0;0;0;0;0;0;0;0;0;0;0;0;0;0;0;0;0;0
Doesburg;8592;5727;1529;603;391;32;149;30;1;926;581;345;511;825;487;322;14;2
Doetinchem;44310;30276;7908;3767;3127;192;234;213;1;4141;3738;403;2304;3822;2809;957;45;11
Dongen;20752;14110;3714;1624;1278;119;114;101;12;2090;1908;182;1261;1667;878;756;27;6
Dongeradeel;0;0;0;0;0;0;0;0;0;0;0;0;0;0;0;0;0;0
Doorn;0;0;0;0;0;0;0;0;0;0;0;0;0;0;0;0;0;0
Dordrecht;85642;57472;14895;9041;7933;320;330;436;22;5854;5299;555;3703;9572;6757;2687;95;33
Drechterland;16480;10024;3905;1881;1557;111;96;102;15;2024;1884;140;1207;1344;555;739;40;10
Driebergen-Rijsenburg;0;0;0;0;0;0;0;0;0;0;0;0;0;0;0;0;0;0
Drimmelen;22763;14981;4811;2225;1889;83;135;107;11;2586;2398;188;1303;1668;921;702;34;11
Dronten;31851;21054;7002;2772;2315;120;186;141;10;4230;3916;314;1819;1976;995;930;36;15
Druten;15314;10050;3153;1523;1193;91;155;82;2;1630;1430;200;839;1272;781;473;13;5
Duiven;22801;13960;5956;1851;1300;164;328;59;0;4105;1813;2292;1165;1720;1261;432;23;4
Echt;0;0;0;0;0;0;0;0;0;0;0;0;0;0;0;0;0;0
Echteld;0;0;0;0;0;0;0;0;0;0;0;0;0;0;0;0;0;0
Echt-Susteren;27845;18678;5023;2340;1849;139;231;106;15;2683;2369;314;1626;2518;1496;960;54;8
Edam-Volendam;24810;14943;5670;3189;2806;134;122;105;22;2481;2251;230;1104;3093;2215;830;39;9
Ede;87997;56167;19273;9569;7389;857;898;403;22;9704;8582;1122;4547;8010;4667;3088;217;38
Eemnes;8251;5190;1612;750;660;44;19;27;0;862;835;27;482;967;484;466;10;7
Eemsmond;0;0;0;0;0;0;0;0;0;0;0;0;0;0;0;0;0;0
Eersel;18183;11140;4417;1993;1580;99;213;96;5;2424;2008;416;1109;1517;912;563;35;7
Egmond;0;0;0;0;0;0;0;0;0;0;0;0;0;0;0;0;0;0
Eibergen;0;0;0;0;0;0;0;0;0;0;0;0;0;0;0;0;0;0
Eijsden;0;0;0;0;0;0;0;0;0;0;0;0;0;0;0;0;0;0
Eijsden-Margraten;21450;14574;3518;1672;1313;132;80;146;1;1846;1732;114;1151;2207;1362;799;35;11
Eindhoven;144394;101033;19903;11133;8033;1315;698;1076;11;8770;7588;1182;6873;16585;12729;3639;161;56
Elburg;18035;11728;3897;1599;1346;73;80;100;0;2298;2218;80;867;1543;904;592;36;11
Elst;0;0;0;0;0;0;0;0;0;0;0;0;0;0;0;0;0;0
Emmen;87607;56121;18389;7656;6116;398;660;477;5;10733;9640;1093;5051;8046;5099;2772;133;42
Enkhuizen;11895;7931;2124;1049;918;23;40;68;0;1075;1031;44;668;1172;612;534;19;7
Enschede;100182;67648;15017;6981;5624;512;359;483;3;8036;7456;580;5213;12304;8612;3503;142;47
Epe;28835;18147;6276;2573;2102;127;171;173;0;3703;3406;297;1417;2995;1666;1254;56;19
Ermelo;21081;13427;4891;2126;1401;213;400;111;1;2765;2256;509;1199;1564;963;557;33;11
Etten-Leur;31489;22104;5474;2536;1893;235;302;101;5;2938;2409;529;1708;2203;1224;941;31;7
Ferwerderadiel;0;0;0;0;0;0;0;0;0;0;0;0;0;0;0;0;0;0
Franekeradeel;0;0;0;0;0;0;0;0;0;0;0;0;0;0;0;0;0;0
De Friese Meren;0;0;0;0;0;0;0;0;0;0;0;0;0;0;0;0;0;0
De Fryske Marren;44501;28132;10462;4781;4032;219;239;269;22;5681;5403;278;2855;3052;1368;1579;88;17
Gaasterlân-Sleat;0;0;0;0;0;0;0;0;0;0;0;0;0;0;0;0;0;0
Geertruidenberg;16811;11489;3310;1483;1169;76;162;73;3;1827;1555;272;918;1094;555;489;40;10
Geldermalsen;0;0;0;0;0;0;0;0;0;0;0;0;0;0;0;0;0;0
Geldrop;0;0;0;0;0;0;0;0;0;0;0;0;0;0;0;0;0;0
Geldrop-Mierlo;31757;21455;5465;2710;2322;87;143;148;10;2755;2518;237;1623;3214;2416;745;40;13
Geleen;0;0;0;0;0;0;0;0;0;0;0;0;0;0;0;0;0;0
Gemert-Bakel;27753;16591;6311;3115;2510;205;201;193;6;3196;2918;278;1845;3006;1733;1225;42;6
Gendringen;0;0;0;0;0;0;0;0;0;0;0;0;0;0;0;0;0;0
Gendt;0;0;0;0;0;0;0;0;0;0;0;0;0;0;0;0;0;0
Genemuiden;0;0;0;0;0;0;0;0;0;0;0;0;0;0;0;0;0;0
Gennep;14950;9456;3636;1357;925;121;214;95;2;2279;1516;763;796;1062;562;473;25;2
Giessenlanden;0;0;0;0;0;0;0;0;0;0;0;0;0;0;0;0;0;0
Gilze en Rijen;20787;13954;3996;1768;1359;83;138;187;1;2228;1977;251;1336;1501;714;766;17;4
Goedereede;0;0;0;0;0;0;0;0;0;0;0;0;0;0;0;0;0;0
Goeree-Overflakkee;42089;26309;9806;4395;3386;175;575;175;84;5411;4623;788;2480;3494;1885;1511;91;7
Goes;29628;20432;5316;2713;2291;135;149;137;1;2603;2450;153;1523;2357;1347;965;34;11
Goirle;17543;12190;2891;1253;1030;87;40;90;6;1638;1598;40;1071;1391;895;476;17;3
Gooise Meren;37271;28089;3893;2019;1765;98;13;143;0;1874;1831;43;1864;3425;1743;1622;40;20
Goor;0;0;0;0;0;0;0;0;0;0;0;0;0;0;0;0;0;0
Gorinchem;25286;16460;4954;1974;1668;103;91;103;9;2980;1705;1275;1115;2757;1730;976;42;9
Gorssel;0;0;0;0;0;0;0;0;0;0;0;0;0;0;0;0;0;0
Gouda;41065;29034;5856;3075;2677;108;107;166;17;2781;2535;246;2251;3924;2523;1356;27;18
Graafstroom;0;0;0;0;0;0;0;0;0;0;0;0;0;0;0;0;0;0
Graft-De Rijp;0;0;0;0;0;0;0;0;0;0;0;0;0;0;0;0;0;0
Gramsbergen;0;0;0;0;0;0;0;0;0;0;0;0;0;0;0;0;0;0
Grave;10151;6810;1601;630;511;21;24;74;0;971;941;30;660;1080;671;394;11;4
's-Graveland;0;0;0;0;0;0;0;0;0;0;0;0;0;0;0;0;0;0
's-Gravendeel;0;0;0;0;0;0;0;0;0;0;0;0;0;0;0;0;0;0
's-Gravenhage (gemeente);272367;196504;28112;20618;18862;501;244;782;229;7494;7191;303;10740;37011;27130;9435;334;112
's-Gravenzande;0;0;0;0;0;0;0;0;0;0;0;0;0;0;0;0;0;0
Groenlo;0;0;0;0;0;0;0;0;0;0;0;0;0;0;0;0;0;0
Groesbeek;0;0;0;0;0;0;0;0;0;0;0;0;0;0;0;0;0;0
Groningen (gemeente);134083;92872;20674;12078;10484;407;332;804;51;8596;8095;501;6211;14326;9764;4262;123;177
Grootegast;0;0;0;0;0;0;0;0;0;0;0;0;0;0;0;0;0;0
Grubbenvorst;0;0;0;0;0;0;0;0;0;0;0;0;0;0;0;0;0;0
Gulpen-Wittem;11817;8258;1765;828;706;49;8;62;3;937;925;12;659;1135;686;426;21;2
Haaksbergen;20228;13113;4370;1775;1469;94;104;105;3;2595;2452;143;1374;1371;695;656;14;6
Haaren;13403;7981;3665;1617;1260;99;196;60;2;2048;1794;254;701;1056;530;499;20;7
Haarlem;87932;61949;9436;5717;4805;264;134;399;115;3719;3554;165;5342;11205;7595;3458;114;38
Haarlemmerliede en Spaarnwoude;0;0;0;0;0;0;0;0;0;0;0;0;0;0;0;0;0;0
Haarlemmermeer;170177;117326;30769;20378;17376;1269;1220;466;47;10391;8866;1525;7234;14848;8603;6066;127;52
Haelen;0;0;0;0;0;0;0;0;0;0;0;0;0;0;0;0;0;0
Halderberge;25081;16569;5094;2246;1774;147;216;100;9;2848;2493;355;1408;2010;1070;898;31;11
Den Ham;0;0;0;0;0;0;0;0;0;0;0;0;0;0;0;0;0;0
Hardenberg;52331;32342;13246;5558;4436;316;544;261;1;7688;6862;826;3639;3104;1440;1554;86;24
Harderwijk;33631;22317;6284;2804;2261;138;261;137;7;3480;3084;396;1764;3266;2454;771;36;5
Hardinxveld-Giessendam;13833;8535;3643;1625;1324;111;137;35;18;2018;1796;222;595;1060;529;498;28;5
Haren;0;0;0;0;0;0;0;0;0;0;0;0;0;0;0;0;0;0
Harenkarspel;0;0;0;0;0;0;0;0;0;0;0;0;0;0;0;0;0;0
Harlingen;11300;7192;2252;1127;882;64;69;108;4;1125;1027;98;678;1178;640;488;40;10
Harmelen;0;0;0;0;0;0;0;0;0;0;0;0;0;0;0;0;0;0
Hasselt;0;0;0;0;0;0;0;0;0;0;0;0;0;0;0;0;0;0
Hattem;9447;6098;1787;634;532;30;19;53;0;1153;1132;21;583;979;558;405;11;5
Heel;0;0;0;0;0;0;0;0;0;0;0;0;0;0;0;0;0;0
Heemskerk;27063;18699;3659;1698;1471;60;63;103;1;1961;1894;67;1683;3022;1845;1122;45;10
Heemstede;17042;13336;1427;687;582;62;4;38;1;740;713;27;740;1539;1076;441;18;4
Heerde;15991;9981;3344;1368;1139;82;74;71;2;1976;1901;75;987;1679;965;675;36;3
Heerenveen;41872;25962;10848;5431;2976;318;506;308;1323;5417;4471;946;2330;2732;1092;1565;65;10
Heerhugowaard;40671;27111;6763;3147;2712;137;104;190;4;3616;3465;151;2575;4222;2209;1971;31;11
Heerjansdam;0;0;0;0;0;0;0;0;0;0;0;0;0;0;0;0;0;0
Heerlen;62729;44385;7759;3795;2957;264;294;271;9;3964;3069;895;3244;7341;4318;2774;212;37
Heeze-Leende;14057;9110;2982;1265;1059;64;66;73;3;1717;1619;98;846;1119;729;369;13;8
Heiloo;16005;11315;2296;952;818;44;14;76;0;1344;1330;14;1025;1369;853;497;14;5
Heino;0;0;0;0;0;0;0;0;0;0;0;0;0;0;0;0;0;0
Helden;0;0;0;0;0;0;0;0;0;0;0;0;0;0;0;0;0;0
Den Helder;37130;25054;4919;2222;1904;64;60;187;7;2697;2618;79;2378;4779;2796;1879;80;24
Hellendoorn;30176;19855;6334;2512;2060;115;168;159;10;3822;3615;207;1991;1996;997;958;32;9
Hellevoetsluis;31447;21434;4588;1996;1633;48;208;107;0;2592;2194;398;1756;3669;1986;1629;42;12
Helmond;63276;43494;9312;4528;3754;232;297;229;16;4784;4264;520;2940;7530;6009;1407;100;14
Hendrik-Ido-Ambacht;19690;14472;2474;1068;968;30;25;45;0;1406;1370;36;977;1767;1105;641;16;5
Hengelo (Gld.);0;0;0;0;0;0;0;0;0;0;0;0;0;0;0;0;0;0
Hengelo (O.);61458;42706;9831;4635;3964;233;200;228;10;5196;5014;182;3645;5276;3465;1739;50;22
's-Hertogenbosch;113697;80430;17281;9371;7845;657;323;538;8;7910;7335;575;4498;11488;9263;2029;159;37
Heteren;0;0;0;0;0;0;0;0;0;0;0;0;0;0;0;0;0;0
Heumen;12408;8669;2220;829;679;27;64;59;0;1391;1323;68;660;859;586;257;13;3
Heusden;36024;24008;6804;3236;2668;180;242;143;3;3568;3256;312;1866;3346;2095;1156;84;11
Heythuysen;0;0;0;0;0;0;0;0;0;0;0;0;0;0;0;0;0;0
Hillegom;17580;11486;2882;1521;1073;133;260;55;0;1361;1079;282;1102;2110;1272;799;33;6
Hilvarenbeek;15593;8792;4899;1816;1264;142;327;82;1;3083;1718;1365;776;1126;527;569;25;5
Hilversum;57214;40587;7492;4871;3117;120;54;209;1371;2621;2564;57;3032;6103;3578;2407;73;45
Hoeksche Waard;70810;46493;14329;6354;5183;331;537;295;8;7975;6818;1157;3836;6152;2353;3650;130;19
Hof van Twente;30603;19511;7088;2919;2411;127;159;135;87;4169;3860;309;1763;2241;1100;1081;50;10
Het Hogeland;38194;24209;8586;3646;3094;125;184;228;15;4940;4677;263;2521;2878;1154;1598;84;42
Hollands Kroon;44771;26231;11948;5565;4172;407;673;294;19;6383;5552;831;3181;3411;1115;2166;105;25
Holten;0;0;0;0;0;0;0;0;0;0;0;0;0;0;0;0;0;0
Hontenisse;0;0;0;0;0;0;0;0;0;0;0;0;0;0;0;0;0;0
Hoogeveen;44878;27762;10300;4593;3784;209;316;232;52;5707;5298;409;2538;4278;3118;1067;86;7
Hoogezand-Sappemeer;0;0;0;0;0;0;0;0;0;0;0;0;0;0;0;0;0;0
Hoorn;49861;32698;9939;5558;4963;216;145;231;3;4381;4198;183;2640;4584;2558;1929;77;20
Horst;0;0;0;0;0;0;0;0;0;0;0;0;0;0;0;0;0;0
Horst aan de Maas;40695;24430;10273;3599;2690;287;391;209;22;6674;4375;2299;2529;3463;1627;1758;62;16
Houten;69223;55225;9455;6785;6391;157;141;95;1;2670;2509;161;1698;2845;1553;1249;29;14
Huissen;0;0;0;0;0;0;0;0;0;0;0;0;0;0;0;0;0;0
Huizen;29959;22120;3805;1772;1559;31;37;145;0;2033;1985;48;1581;2453;1267;1133;42;11
Hulst;22928;16210;4051;1787;1423;104;180;79;1;2264;2031;233;1230;1437;541;829;51;16
Hummelo en Keppel;0;0;0;0;0;0;0;0;0;0;0;0;0;0;0;0;0;0
Hunsel;0;0;0;0;0;0;0;0;0;0;0;0;0;0;0;0;0;0
IJsselham;0;0;0;0;0;0;0;0;0;0;0;0;0;0;0;0;0;0
IJsselmuiden;0;0;0;0;0;0;0;0;0;0;0;0;0;0;0;0;0;0
IJsselstein;21093;15216;2875;1373;1214;63;47;49;0;1502;1453;49;1256;1746;833;866;34;13
Jacobswoude;0;0;0;0;0;0;0;0;0;0;0;0;0;0;0;0;0;0
Kaag en Braassem;22083;14062;4495;2187;1808;174;118;86;1;2308;2169;139;1396;2130;1001;1083;33;13
Kampen;37407;23017;8620;3732;2922;201;425;184;0;4888;4231;657;1959;3811;2579;1183;41;8
Kapelle;10833;6820;2372;1089;810;67;126;54;32;1283;1106;177;709;932;439;475;11;7
Katwijk;42001;26027;6510;3806;2755;516;419;109;7;2704;2288;416;2112;7352;6214;1046;69;23
Kerkrade;33576;23898;4331;2042;1582;119;226;91;24;2289;1711;578;1928;3419;1785;1515;109;10
Kessel;0;0;0;0;0;0;0;0;0;0;0;0;0;0;0;0;0;0
Kesteren;0;0;0;0;0;0;0;0;0;0;0;0;0;0;0;0;0;0
Koggenland;20954;12054;5524;2628;2097;184;187;135;25;2896;2656;240;1502;1874;701;1130;27;16
Kollumerland en Nieuwkruisland;0;0;0;0;0;0;0;0;0;0;0;0;0;0;0;0;0;0
Korendijk;0;0;0;0;0;0;0;0;0;0;0;0;0;0;0;0;0;0
Krimpen aan den IJssel;19610;13430;2814;1244;1034;87;61;62;0;1570;1498;72;1075;2291;1229;1023;29;10
Krimpenerwaard;45388;27464;11247;5115;3929;274;709;202;1;6132;4905;1227;2649;4028;1683;2249;63;33
Laarbeek;20162;12209;4544;2016;1572;161;172;110;1;2528;2282;246;1138;2271;1433;797;35;6
Landerd;14728;8995;3810;1697;1287;87;194;121;8;2113;1840;273;858;1065;617;420;19;9
Landgraaf;29078;21023;3609;1729;1374;93;136;126;0;1880;1719;161;1687;2759;1611;1050;88;10
Landsmeer;8713;5655;1335;607;525;19;22;41;0;728;696;32;591;1132;728;388;8;8
Langedijk;22910;14412;4359;1925;1525;131;146;123;0;2434;2166;268;1696;2443;1310;1089;33;11
Lansingerland;47376;30566;9246;4442;3305;308;626;194;9;4804;3626;1178;2354;5210;2767;2386;41;16
Laren (NH.);8626;6607;804;421;390;12;1;18;0;383;381;2;402;813;442;354;11;6
Leek;0;0;0;0;0;0;0;0;0;0;0;0;0;0;0;0;0;0
Leerdam;0;0;0;0;0;0;0;0;0;0;0;0;0;0;0;0;0;0
Leersum;0;0;0;0;0;0;0;0;0;0;0;0;0;0;0;0;0;0
Leeuwarden;78928;53712;13654;6439;5306;380;210;527;16;7215;6906;309;4173;7389;4547;2677;138;27
Leeuwarderadeel;0;0;0;0;0;0;0;0;0;0;0;0;0;0;0;0;0;0
Leiden;58820;39585;6039;3531;3059;137;51;283;1;2508;2455;53;2975;10221;7892;2212;65;52
Leiderdorp;18246;12922;1995;1074;956;48;39;31;0;921;854;67;1016;2313;1747;545;13;8
Leidschendam;0;0;0;0;0;0;0;0;0;0;0;0;0;0;0;0;0;0
Leidschendam-Voorburg;48725;35656;5479;3429;3043;171;88;126;1;2050;1961;89;2281;5309;3422;1813;63;11
Lelystad;51314;35157;7566;3381;2963;87;74;247;10;4185;4086;99;2845;5746;4001;1634;90;21
Lemsterland;0;0;0;0;0;0;0;0;0;0;0;0;0;0;0;0;0;0
Leudal;33332;21108;7282;3165;2531;234;228;157;15;4117;3746;371;2018;2924;1319;1543;49;13
Leusden;21772;15322;3215;1246;1085;32;26;102;1;1969;1946;23;1480;1755;1112;618;17;8
Lichtenvoorde;0;0;0;0;0;0;0;0;0;0;0;0;0;0;0;0;0;0
Liemeer;0;0;0;0;0;0;0;0;0;0;0;0;0;0;0;0;0;0
De Lier;0;0;0;0;0;0;0;0;0;0;0;0;0;0;0;0;0;0
Liesveld;0;0;0;0;0;0;0;0;0;0;0;0;0;0;0;0;0;0
Limmen;0;0;0;0;0;0;0;0;0;0;0;0;0;0;0;0;0;0
Lingewaal;0;0;0;0;0;0;0;0;0;0;0;0;0;0;0;0;0;0
Lingewaard;36859;23819;6645;2792;2121;191;340;140;0;3853;3396;457;2180;4215;2988;1182;32;13
Lisse;16984;11624;2421;1259;1063;89;68;39;0;1162;1098;64;999;1940;1120;790;25;5
Lith;0;0;0;0;0;0;0;0;0;0;0;0;0;0;0;0;0;0
Littenseradiel;0;0;0;0;0;0;0;0;0;0;0;0;0;0;0;0;0;0
Lochem;28637;19098;5946;2310;1844;132;176;158;0;3636;3434;202;2059;1534;817;659;44;14
Loenen;0;0;0;0;0;0;0;0;0;0;0;0;0;0;0;0;0;0
Loon op Zand;19006;12671;3417;1461;1254;74;37;95;1;1956;1914;42;1115;1803;1125;641;31;6
Loosdrecht;0;0;0;0;0;0;0;0;0;0;0;0;0;0;0;0;0;0
Lopik;13889;7574;4339;2041;1593;146;213;88;1;2298;1976;322;799;1177;418;735;21;3
Loppersum;8416;5158;1903;803;702;20;27;54;0;1100;1066;34;732;623;219;376;19;9
Losser;18529;12086;3519;1278;1056;55;74;82;11;2241;2128;113;1055;1869;1178;661;27;3
Maarn;0;0;0;0;0;0;0;0;0;0;0;0;0;0;0;0;0;0
Maarssen;0;0;0;0;0;0;0;0;0;0;0;0;0;0;0;0;0;0
Maartensdijk;0;0;0;0;0;0;0;0;0;0;0;0;0;0;0;0;0;0
Maasbracht;0;0;0;0;0;0;0;0;0;0;0;0;0;0;0;0;0;0
Maasbree;0;0;0;0;0;0;0;0;0;0;0;0;0;0;0;0;0;0
Maasdonk;0;0;0;0;0;0;0;0;0;0;0;0;0;0;0;0;0;0
Maasdriel;23655;13896;6301;3158;2409;219;310;149;71;3143;2760;383;1248;2210;1260;897;42;11
Maasgouw;20752;14004;3714;1736;1419;115;76;123;3;1978;1877;101;1243;1791;1007;750;29;5
Maasland;0;0;0;0;0;0;0;0;0;0;0;0;0;0;0;0;0;0
Maassluis;20322;14898;2068;1043;910;35;46;52;0;1025;986;39;899;2457;1499;921;32;5
Maastricht;69729;45717;8075;4451;3669;295;213;262;12;3624;3292;332;2791;13146;9899;3034;167;46
Margraten;0;0;0;0;0;0;0;0;0;0;0;0;0;0;0;0;0;0
Markelo;0;0;0;0;0;0;0;0;0;0;0;0;0;0;0;0;0;0
De Marne;0;0;0;0;0;0;0;0;0;0;0;0;0;0;0;0;0;0
Marum;0;0;0;0;0;0;0;0;0;0;0;0;0;0;0;0;0;0
Medemblik;41136;23399;11699;5451;3482;449;1243;274;3;6248;4505;1743;2573;3465;1268;2103;83;11
Meerlo-Wanssum;0;0;0;0;0;0;0;0;0;0;0;0;0;0;0;0;0;0
Meerssen;15716;10566;2329;1029;839;52;77;57;4;1300;1131;169;926;1895;1283;576;32;4
Meierijstad;73536;45070;18871;8867;6815;544;1081;390;37;10004;7519;2485;3911;5684;3463;2093;106;22
Meijel;0;0;0;0;0;0;0;0;0;0;0;0;0;0;0;0;0;0
Menaldumadeel;0;0;0;0;0;0;0;0;0;0;0;0;0;0;0;0;0;0
Menameradiel;0;0;0;0;0;0;0;0;0;0;0;0;0;0;0;0;0;0
Menterwolde;0;0;0;0;0;0;0;0;0;0;0;0;0;0;0;0;0;0
Meppel;24100;16413;4451;1975;1570;111;189;90;15;2476;2291;185;1521;1715;921;767;23;4
Middelburg (Z.);33551;22725;5831;2873;1998;158;160;276;281;2958;2741;217;1752;3243;2000;1197;29;17
Middelharnis;0;0;0;0;0;0;0;0;0;0;0;0;0;0;0;0;0;0
Midden-Delfland;14974;9239;3017;1635;1240;135;119;130;11;1382;1266;116;853;1865;956;891;12;6
Midden-Drenthe;30395;18432;7795;3232;2743;113;196;177;3;4563;4261;302;2114;2054;1075;930;36;13
Midden-Groningen;50508;32283;10786;4074;3278;233;247;297;19;6712;6252;460;3309;4130;2087;1890;124;29
Mierlo;0;0;0;0;0;0;0;0;0;0;0;0;0;0;0;0;0;0
Mill en Sint Hubert;11287;6641;2908;1221;988;82;91;60;0;1687;1409;278;697;1041;492;519;25;5
Millingen aan de Rijn;0;0;0;0;0;0;0;0;0;0;0;0;0;0;0;0;0;0
Moerdijk;35115;21209;9911;4003;2635;285;876;164;43;5908;3280;2628;1893;2102;857;1167;61;17
Molenlanden;40029;22809;11393;5284;3851;384;803;237;9;6109;4857;1252;2063;3764;1640;2042;62;20
Molenwaard;0;0;0;0;0;0;0;0;0;0;0;0;0;0;0;0;0;0
Monster;0;0;0;0;0;0;0;0;0;0;0;0;0;0;0;0;0;0
Montferland;30484;19635;6364;2833;2221;217;255;125;15;3531;3024;507;1868;2617;1570;956;81;10
Montfoort;11093;6959;2768;1331;1085;115;89;42;0;1437;1325;112;556;810;378;420;9;3
Mook en Middelaar;6537;4622;1063;443;385;17;6;34;1;620;603;17;344;508;342;153;11;2
Moordrecht;0;0;0;0;0;0;0;0;0;0;0;0;0;0;0;0;0;0
Muiden;0;0;0;0;0;0;0;0;0;0;0;0;0;0;0;0;0;0
Naaldwijk;0;0;0;0;0;0;0;0;0;0;0;0;0;0;0;0;0;0
Naarden;0;0;0;0;0;0;0;0;0;0;0;0;0;0;0;0;0;0
Neder-Betuwe;20937;12360;5822;2846;2189;184;358;100;15;2976;2444;532;944;1811;856;883;60;12
Nederhorst den Berg;0;0;0;0;0;0;0;0;0;0;0;0;0;0;0;0;0;0
Nederlek;0;0;0;0;0;0;0;0;0;0;0;0;0;0;0;0;0;0
Nederweert;16190;10163;3796;1720;1436;96;105;80;3;2076;1877;199;922;1309;763;510;29;7
Neede;0;0;0;0;0;0;0;0;0;0;0;0;0;0;0;0;0;0
Neerijnen;0;0;0;0;0;0;0;0;0;0;0;0;0;0;0;0;0;0
Niedorp;0;0;0;0;0;0;0;0;0;0;0;0;0;0;0;0;0;0
Nieuwegein;42458;29650;6414;3489;2912;151;195;217;14;2925;2677;248;2202;4192;2360;1765;51;16
Nieuwerkerk aan den IJssel;0;0;0;0;0;0;0;0;0;0;0;0;0;0;0;0;0;0
Nieuwkoop;26635;16187;6103;2988;2366;234;235;134;19;3115;2744;371;1747;2598;962;1588;38;10
Nieuw-Lekkerland;0;0;0;0;0;0;0;0;0;0;0;0;0;0;0;0;0;0
Nieuwleusen;0;0;0;0;0;0;0;0;0;0;0;0;0;0;0;0;0;0
Nijefurd;0;0;0;0;0;0;0;0;0;0;0;0;0;0;0;0;0;0
Nijkerk;34877;21755;8259;3640;2853;341;307;137;2;4619;4227;392;1961;2902;1749;1084;58;11
Nijmegen;94930;68027;11480;6099;4524;446;574;525;30;5381;4128;1253;4526;10897;7956;2772;138;31
Nissewaard;58331;40288;7690;3211;2730;105;203;171;2;4479;3771;708;3344;7009;3236;3668;82;23
Noardeast-Fryslân;38022;23518;9078;4181;3498;228;209;244;2;4897;4612;285;2093;3333;1298;1904;115;16
Noord-Beveland;7179;4389;1578;767;678;17;21;50;1;811;789;22;439;773;390;358;19;6
Noordenveld;26569;17419;5512;1995;1653;77;105;155;5;3517;3362;155;1650;1988;970;977;30;11
Noorder-Koggenland;0;0;0;0;0;0;0;0;0;0;0;0;0;0;0;0;0;0
Noordoostpolder;38588;24318;9208;4097;3500;137;219;226;15;5111;4772;339;2283;2779;1174;1546;47;12
Noordwijk;33321;21456;5079;2836;2231;246;129;146;84;2243;2089;154;1744;5042;3228;1768;38;8
Noordwijkerhout;0;0;0;0;0;0;0;0;0;0;0;0;0;0;0;0;0;0
Nootdorp;0;0;0;0;0;0;0;0;0;0;0;0;0;0;0;0;0;0
Nuenen, Gerwen en Nederwetten;18625;12939;3149;1230;1066;49;49;65;1;1919;1857;62;964;1573;1158;392;16;7
Nunspeet;21326;13572;5102;2398;2055;129;104;95;15;2704;2602;102;1037;1615;1037;524;36;18
Nuth;0;0;0;0;0;0;0;0;0;0;0;0;0;0;0;0;0;0
Obdam;0;0;0;0;0;0;0;0;0;0;0;0;0;0;0;0;0;0
Oegstgeest;13830;10494;1249;585;425;38;85;37;0;664;584;80;627;1460;1014;421;15;10
Oirschot;17237;10748;3949;1843;1565;116;81;72;9;2106;1997;109;931;1609;1037;543;23;6
Oisterwijk;20305;13930;3591;1604;1325;94;94;91;0;1987;1819;168;1045;1739;1170;538;23;8
Oldambt;30665;20211;6155;2466;1994;139;162;163;8;3689;3462;227;2122;2177;1051;1031;87;8
Oldebroek;19749;11774;5258;2382;1819;188;229;139;7;2876;2621;255;1073;1644;1057;555;27;5
Oldenzaal;30412;20572;6937;2399;1685;131;415;143;25;4538;2502;2036;1103;1800;1152;615;25;8
Olst;0;0;0;0;0;0;0;0;0;0;0;0;0;0;0;0;0;0
Olst-Wijhe;15388;9625;3150;1198;960;42;97;84;15;1952;1814;138;992;1621;855;732;23;11
Ommen;15621;9699;3925;1554;1270;77;119;86;2;2371;2222;149;1109;888;360;500;24;4
Onderbanken;0;0;0;0;0;0;0;0;0;0;0;0;0;0;0;0;0;0
Oost Gelre;25561;15994;6446;3150;2366;299;257;217;11;3296;2985;311;1648;1473;742;676;44;11
Oostburg;0;0;0;0;0;0;0;0;0;0;0;0;0;0;0;0;0;0
Oosterhout;43932;30366;8246;3977;3006;308;417;230;16;4269;3329;940;2145;3175;1876;1230;61;8
Oostflakkee;0;0;0;0;0;0;0;0;0;0;0;0;0;0;0;0;0;0
Ooststellingwerf;23397;14140;5879;2419;1851;159;238;167;4;3460;3148;312;1814;1564;634;864;52;14
Oostzaan;8014;4901;1424;671;493;83;38;57;0;753;674;79;588;1101;713;372;10;6
Ootmarsum;0;0;0;0;0;0;0;0;0;0;0;0;0;0;0;0;0;0
Opmeer;10444;6329;2550;1186;980;58;54;93;1;1364;1302;62;800;765;242;488;28;7
Opsterland;26235;16393;5996;2454;2069;116;71;194;4;3542;3447;95;1806;2040;711;1268;49;12
Oss;75669;47282;17211;7318;5968;414;554;319;63;9893;7011;2882;3667;7509;5392;1904;185;28
Oud-Beijerland;0;0;0;0;0;0;0;0;0;0;0;0;0;0;0;0;0;0
Oude IJsselstreek;31902;21144;6300;2852;2357;148;129;218;0;3448;3233;215;2046;2412;1312;1044;46;10
Ouder-Amstel;10415;6435;2067;1433;1211;83;68;37;34;634;557;77;504;1409;771;622;2;14
Ouderkerk;0;0;0;0;0;0;0;0;0;0;0;0;0;0;0;0;0;0
Oudewater;8738;5097;2586;1320;954;185;140;41;0;1266;1098;168;444;611;247;348;9;7
Overbetuwe;39473;26366;7611;3642;2802;287;194;287;72;3969;3755;214;2185;3311;1970;1255;61;25
Papendrecht;23175;15771;4576;1740;1009;125;545;61;0;2836;1636;1200;1052;1776;1018;740;17;1
Peel en Maas;37209;24206;7929;3482;2770;212;269;188;43;4447;3902;545;2224;2850;1515;1282;42;11
Pekela;10742;6927;2214;864;647;37;101;78;1;1350;1215;135;716;885;450;400;32;3
Pijnacker;0;0;0;0;0;0;0;0;0;0;0;0;0;0;0;0;0;0
Pijnacker-Nootdorp;35959;24400;5244;2679;2188;148;239;98;6;2565;2362;203;2176;4139;2452;1656;15;16
Purmerend;64504;44123;10004;6583;5958;110;93;168;254;3421;3283;138;3172;7205;4210;2884;92;19
Putten;20265;12386;5399;2441;1934;169;251;86;1;2958;2641;317;950;1530;919;583;26;2
Raalte;31846;20068;7080;2991;2362;200;219;157;53;4089;3846;243;2152;2546;1391;1102;44;9
Ravenstein;0;0;0;0;0;0;0;0;0;0;0;0;0;0;0;0;0;0
Reeuwijk;0;0;0;0;0;0;0;0;0;0;0;0;0;0;0;0;0;0
Reiderland;0;0;0;0;0;0;0;0;0;0;0;0;0;0;0;0;0;0
Reimerswaal;18610;11260;4572;2339;1928;91;242;78;0;2233;1826;407;1113;1665;684;928;40;13
Renkum;23030;16380;2973;1254;1089;47;15;103;0;1719;1697;22;1349;2328;1505;779;36;8
Renswoude;4963;2756;1583;775;573;51;136;15;0;808;592;216;254;370;166;197;6;1
Reusel-De Mierden;12201;7443;3086;1359;1126;65;101;66;1;1727;1575;152;689;983;570;397;13;3
Rheden;31038;22067;4259;1892;1658;64;19;149;2;2367;2337;30;1720;2992;2037;902;40;13
Rhenen;15948;10128;3101;1445;1256;64;54;70;1;1656;1592;64;835;1884;1120;722;32;10
Ridderkerk;35623;22996;7330;3037;2317;188;278;234;20;4293;3686;607;1708;3589;2292;1230;56;11
Rijnsburg;0;0;0;0;0;0;0;0;0;0;0;0;0;0;0;0;0;0
Rijnwaarden;0;0;0;0;0;0;0;0;0;0;0;0;0;0;0;0;0;0
Rijnwoude;0;0;0;0;0;0;0;0;0;0;0;0;0;0;0;0;0;0
Rijssen;0;0;0;0;0;0;0;0;0;0;0;0;0;0;0;0;0;0
Rijssen-Holten;31955;19517;8929;3598;2365;322;762;146;3;5331;3875;1456;1434;2075;981;1038;48;8
Rijswijk (ZH.);38523;29473;3228;1968;1809;59;29;70;1;1260;1231;29;1595;4227;2969;1211;37;10
Roerdalen;17951;12152;3049;1263;987;56;129;87;4;1786;1552;234;1102;1648;985;619;35;9
Roermond;41059;28954;5990;2941;2450;167;148;171;5;3049;2707;342;1943;4172;2882;1200;81;9
Roggel en Neer;0;0;0;0;0;0;0;0;0;0;0;0;0;0;0;0;0;0
De Ronde Venen;36285;23532;7417;3617;2853;306;290;161;7;3800;3422;378;1985;3351;1371;1931;31;18
Roosendaal;60206;39185;13363;5573;3822;369;1050;319;13;7790;4498;3292;2744;4914;2799;2038;62;15
Rotterdam;330666;225210;53681;24692;20079;1073;1961;1149;430;28989;12203;16786;12606;39169;24447;14215;382;125
Rozenburg;0;0;0;0;0;0;0;0;0;0;0;0;0;0;0;0;0;0
Rozendaal;1303;955;182;80;32;8;34;6;0;102;73;29;84;82;66;15;1;0
Rucphen;21002;13110;4585;2253;1900;131;120;88;14;2332;2073;259;1191;2116;1356;713;41;6
Ruurlo;0;0;0;0;0;0;0;0;0;0;0;0;0;0;0;0;0;0
Sas van Gent;0;0;0;0;0;0;0;0;0;0;0;0;0;0;0;0;0;0
Sassenheim;0;0;0;0;0;0;0;0;0;0;0;0;0;0;0;0;0;0
Schagen;39753;24843;8983;4265;3548;174;223;316;4;4718;4411;307;2886;3041;1212;1717;90;22
Scheemda;0;0;0;0;0;0;0;0;0;0;0;0;0;0;0;0;0;0
Schermer;0;0;0;0;0;0;0;0;0;0;0;0;0;0;0;0;0;0
Scherpenzeel;8251;5019;2236;1018;732;50;203;33;0;1218;813;405;430;566;297;249;12;8
Schiedam;44265;30167;5868;3455;2666;189;224;374;2;2413;2066;347;1974;6256;4296;1889;47;24
Schiermonnikoog;548;342;116;69;64;3;0;1;1;47;47;0;16;74;31;40;2;1
Schijndel;0;0;0;0;0;0;0;0;0;0;0;0;0;0;0;0;0;0
Schinnen;0;0;0;0;0;0;0;0;0;0;0;0;0;0;0;0;0;0
Schipluiden;0;0;0;0;0;0;0;0;0;0;0;0;0;0;0;0;0;0
Schoonhoven;0;0;0;0;0;0;0;0;0;0;0;0;0;0;0;0;0;0
Schoorl;0;0;0;0;0;0;0;0;0;0;0;0;0;0;0;0;0;0
Schouwen-Duiveland;30387;18891;6808;3082;2622;131;108;191;30;3726;3581;145;1837;2851;1426;1334;44;47
Sevenum;0;0;0;0;0;0;0;0;0;0;0;0;0;0;0;0;0;0
Simpelveld;8423;6158;1022;482;404;18;7;30;23;540;528;12;552;691;356;310;19;6
Sint Anthonis;10774;6628;2650;1167;946;50;93;78;0;1483;1348;135;686;810;317;471;16;6
Sint-Michielsgestel;24676;15881;5210;2411;2061;167;77;106;0;2799;2692;107;1343;2242;1465;731;36;10
Sint-Oedenrode;0;0;0;0;0;0;0;0;0;0;0;0;0;0;0;0;0;0
Sittard;0;0;0;0;0;0;0;0;0;0;0;0;0;0;0;0;0;0
Sittard-Geleen;77828;51757;14164;6246;4962;312;367;604;1;7918;7256;662;3891;8016;5200;2654;142;20
Skarsterlân;0;0;0;0;0;0;0;0;0;0;0;0;0;0;0;0;0;0
Sliedrecht;16601;11577;2900;1487;1292;97;45;52;1;1413;1355;58;713;1411;702;667;36;6
Slochteren;0;0;0;0;0;0;0;0;0;0;0;0;0;0;0;0;0;0
Sluis;21345;13673;4680;2206;1765;105;237;93;6;2474;2089;385;1066;1926;735;1134;46;11
Sluis-Aardenburg;0;0;0;0;0;0;0;0;0;0;0;0;0;0;0;0;0;0
Smallingerland;49076;32437;10649;5826;5019;215;324;249;19;4823;4501;322;2358;3632;2052;1488;79;13
Sneek;0;0;0;0;0;0;0;0;0;0;0;0;0;0;0;0;0;0
Soest;34107;23656;5335;2512;2015;172;144;179;2;2823;2594;229;1927;3189;1908;1210;54;17
Someren;18213;10502;5395;2477;1937;179;245;109;7;2918;2404;514;895;1421;902;475;32;12
Son en Breugel;15305;9526;3787;1575;840;343;234;157;1;2212;1760;452;768;1224;765;442;10;7
Spijkenisse;0;0;0;0;0;0;0;0;0;0;0;0;0;0;0;0;0;0
Stad Delden;0;0;0;0;0;0;0;0;0;0;0;0;0;0;0;0;0;0
Stadskanaal;26621;16930;6285;2656;2172;119;229;135;1;3629;3391;238;1643;1763;870;805;78;10
Staphorst;16502;9042;5398;2511;1875;165;346;123;2;2887;2221;666;911;1151;274;834;39;4
Stede Broec;14185;9731;2451;1039;902;59;23;55;0;1412;1391;21;954;1049;467;550;29;3
Steenbergen;20010;13242;3876;1818;1555;101;74;86;2;2058;1943;115;1330;1562;777;746;31;8
Steenderen;0;0;0;0;0;0;0;0;0;0;0;0;0;0;0;0;0;0
Steenwijk;0;0;0;0;0;0;0;0;0;0;0;0;0;0;0;0;0;0
Steenwijkerland;37420;23055;8573;3539;3046;158;125;198;12;5034;4860;174;2503;3289;1612;1586;76;15
Stein (L.);22960;14682;4748;1973;1210;122;493;140;8;2775;1518;1257;1392;2138;1272;812;45;9
Stichtse Vecht;46172;32499;7153;3175;2720;188;109;154;4;3978;3760;218;2405;4115;2172;1874;53;16
Strijen;0;0;0;0;0;0;0;0;0;0;0;0;0;0;0;0;0;0
Súdwest Fryslân;70235;44205;17011;7829;6531;391;499;401;7;9182;8485;697;4176;4843;2172;2469;167;35
Susteren;0;0;0;0;0;0;0;0;0;0;0;0;0;0;0;0;0;0
Swalmen;0;0;0;0;0;0;0;0;0;0;0;0;0;0;0;0;0;0
Tegelen;0;0;0;0;0;0;0;0;0;0;0;0;0;0;0;0;0;0
Terneuzen;44996;30392;8981;3861;2951;212;416;279;3;5120;4132;988;2566;3057;1167;1767;101;22
Terschelling;4556;2358;1205;705;607;39;17;36;6;500;485;15;305;688;311;361;10;6
Texel;15444;7227;5186;2327;1516;75;618;104;14;2859;1469;1390;781;2250;1242;918;67;23
Teylingen;27041;18624;4116;2133;1718;177;127;110;1;1983;1807;176;1447;2854;1833;984;23;14
Tholen;20814;13592;4438;2388;2081;83;120;96;8;2050;1893;157;1156;1628;844;745;30;9
Thorn;0;0;0;0;0;0;0;0;0;0;0;0;0;0;0;0;0;0
Tiel;33653;22965;6340;3516;2871;227;264;132;22;2824;2368;456;1495;2853;1766;1035;42;10
Tilburg;158450;114469;23017;13647;11356;653;882;723;33;9370;7582;1788;6319;14645;10624;3757;209;55
Tubbergen;19968;12095;5347;2712;2295;120;180;92;25;2635;2446;189;1144;1382;574;774;23;11
Twenterand;29526;17970;7766;3284;2610;215;273;165;21;4482;4079;403;1568;2222;1033;1124;53;12
Tynaarlo;30976;21726;5703;2237;1917;82;75;162;1;3466;3379;87;1588;1959;1023;881;40;15
Tytsjerksteradiel;27622;16955;6826;2837;2205;166;287;176;3;3989;3558;431;1568;2273;1005;1205;54;9
Ubbergen;0;0;0;0;0;0;0;0;0;0;0;0;0;0;0;0;0;0
Uden;37579;23623;8764;4778;3794;404;368;201;11;3986;3325;661;2058;3134;2056;1018;51;9
Uitgeest;9801;6481;1700;795;716;23;25;30;1;905;854;51;693;927;568;349;7;3
Uithoorn;21928;14684;3400;1622;1226;108;210;77;1;1778;1523;255;1359;2485;1205;1252;23;5
Urk;12005;7269;2532;1453;1241;56;111;44;1;1079;954;125;306;1898;1564;307;24;3
Utrecht (gemeente);180886;131482;25046;16845;14010;1211;748;845;31;8201;6634;1567;7982;16376;10948;5200;145;83
Utrechtse Heuvelrug;35939;25724;5593;2557;2185;102;64;205;1;3036;2973;63;1961;2661;1295;1293;57;16
Vaals;6440;4876;683;323;252;26;7;35;3;360;351;9;387;494;188;289;12;5
Valburg;0;0;0;0;0;0;0;0;0;0;0;0;0;0;0;0;0;0
Valkenburg (ZH.);0;0;0;0;0;0;0;0;0;0;0;0;0;0;0;0;0;0
Valkenburg aan de Geul;13682;9106;1876;926;747;57;43;43;36;950;889;61;819;1881;1364;483;24;10
Valkenswaard;25938;16830;4388;1926;1581;94;119;114;18;2462;2283;179;1449;3271;2513;721;30;7
Veendam;21852;14628;4354;1699;1389;68;134;108;0;2655;2494;161;1475;1395;677;649;60;9
Veenendaal;45403;31573;7536;3778;3069;202;336;171;0;3758;3312;446;2128;4166;2650;1346;162;8
Veere;19855;11971;4653;2002;1756;87;33;126;0;2651;2599;52;1154;2077;1121;910;33;13
Veghel;0;0;0;0;0;0;0;0;0;0;0;0;0;0;0;0;0;0
Veldhoven;35215;23539;5993;2630;2012;168;211;222;17;3363;3002;361;2063;3620;2821;746;44;9
Velsen;50086;32412;6906;3556;3012;141;204;193;6;3350;3126;224;3514;7254;4981;2177;81;15
Venhuizen;0;0;0;0;0;0;0;0;0;0;0;0;0;0;0;0;0;0
Venlo;76013;48935;16883;5439;3631;432;857;478;41;11444;5159;6285;3297;6898;4879;1905;88;26
Venray;34969;23039;7468;3239;2465;176;443;155;0;4229;3497;732;1849;2613;1404;1128;74;7
Vijfheerenlanden;53228;35388;11759;5658;4321;520;508;228;81;6101;5279;822;2487;3594;1695;1792;69;38
Vianen;0;0;0;0;0;0;0;0;0;0;0;0;0;0;0;0;0;0
Vlaardingen;47209;30508;8942;2824;2352;120;222;125;5;6118;2340;3778;1993;5766;3704;2006;46;10
Vlagtwedde;0;0;0;0;0;0;0;0;0;0;0;0;0;0;0;0;0;0
Vleuten-De Meern;0;0;0;0;0;0;0;0;0;0;0;0;0;0;0;0;0;0
Vlieland;837;401;226;139;117;13;1;8;0;87;87;0;61;149;71;75;0;3
Vlissingen;32485;20652;5535;1858;1519;78;64;192;5;3677;2122;1555;1837;4461;3042;1366;51;2
Vlist;0;0;0;0;0;0;0;0;0;0;0;0;0;0;0;0;0;0
Voerendaal;10072;7219;1446;655;583;25;17;29;1;791;771;20;562;845;475;347;15;8
Voorburg;0;0;0;0;0;0;0;0;0;0;0;0;0;0;0;0;0;0
Voorhout;0;0;0;0;0;0;0;0;0;0;0;0;0;0;0;0;0;0
Voorschoten;16064;11574;1710;799;679;47;30;43;0;911;889;22;850;1930;1299;615;9;7
Voorst;21204;13027;4908;1951;1547;150;119;135;0;2957;2820;137;1341;1928;1160;746;16;6
Vorden;0;0;0;0;0;0;0;0;0;0;0;0;0;0;0;0;0;0
Vriezenveen;0;0;0;0;0;0;0;0;0;0;0;0;0;0;0;0;0;0
Vught;17494;12878;2386;1074;922;45;39;68;0;1312;1182;130;798;1432;1002;399;24;7
Waadhoeke;38834;23876;9310;4247;3443;216;292;289;7;5063;4697;366;2606;3042;1090;1835;100;17
Waalre;12808;9506;1590;609;500;36;17;56;0;981;950;31;693;1019;759;247;10;3
Waalwijk;39141;26462;7525;3816;2965;228;339;284;0;3709;3173;536;1881;3273;1947;1250;60;16
Waddinxveen;21647;14148;4027;1940;1467;104;281;67;21;2087;1828;259;1266;2206;1158;1022;16;10
Wageningen;18316;13365;2366;1123;858;39;143;82;1;1243;1079;164;873;1712;1085;572;43;12
Warmond;0;0;0;0;0;0;0;0;0;0;0;0;0;0;0;0;0;0
Warnsveld;0;0;0;0;0;0;0;0;0;0;0;0;0;0;0;0;0;0
Wassenaar;19266;14285;1850;1021;905;73;12;29;2;829;813;16;758;2373;1495;842;23;13
Wateringen;0;0;0;0;0;0;0;0;0;0;0;0;0;0;0;0;0;0
Waterland;12617;8078;2380;1036;851;57;54;74;0;1344;1240;104;836;1323;606;688;19;10
Weerselo;0;0;0;0;0;0;0;0;0;0;0;0;0;0;0;0;0;0
Weert;36495;25008;6487;2937;2286;193;257;127;74;3550;3036;514;2032;2968;1770;1135;53;10
Weesp;11775;8148;1716;953;816;68;42;26;1;763;703;60;635;1276;606;654;11;5
Wehl;0;0;0;0;0;0;0;0;0;0;0;0;0;0;0;0;0;0
Werkendam;0;0;0;0;0;0;0;0;0;0;0;0;0;0;0;0;0;0
Wervershoof;0;0;0;0;0;0;0;0;0;0;0;0;0;0;0;0;0;0
West Betuwe;49769;28098;14138;6200;4684;550;654;299;13;7938;6828;1110;2496;5037;1605;3328;76;28
West Maas en Waal;18579;11092;4495;2029;1634;124;180;89;2;2466;2250;216;1084;1908;1048;823;30;7
Wester-Koggenland;0;0;0;0;0;0;0;0;0;0;0;0;0;0;0;0;0;0
Westerkwartier;55596;33758;14015;5883;4599;371;367;538;8;8132;7451;681;3575;4248;1859;2243;98;48
Westerveld;17958;11290;4450;1822;1617;53;50;100;2;2628;2577;51;1172;1046;473;524;42;7
Westervoort;10886;7390;1467;563;464;18;32;49;0;904;874;30;699;1330;973;336;17;4
Westerwolde;23938;14576;6141;2391;2012;77;114;176;12;3750;3615;135;1565;1656;696;882;68;10
Westland;92128;55049;20830;11792;8644;1117;1600;358;73;9038;6778;2260;4187;12062;6598;5352;64;48
Weststellingwerf;22771;13942;5623;2366;1997;88;92;179;10;3257;3124;133;1647;1559;617;872;62;8
Westvoorne;13634;8765;2334;972;829;44;42;56;1;1362;1349;13;872;1663;793;819;31;20
Wierden;26133;18714;4849;1998;1663;73;95;134;33;2851;2696;155;1129;1441;800;605;26;10
Wieringen;0;0;0;0;0;0;0;0;0;0;0;0;0;0;0;0;0;0
Wieringermeer;0;0;0;0;0;0;0;0;0;0;0;0;0;0;0;0;0;0
Wijchen;32446;21490;6675;3159;2278;208;492;180;1;3516;3123;393;1602;2679;1853;761;61;4
Wijdemeren;21870;14063;4400;2048;1688;157;100;94;9;2352;2208;144;1203;2204;1097;1055;37;15
Wijhe;0;0;0;0;0;0;0;0;0;0;0;0;0;0;0;0;0;0
Wijk bij Duurstede;17655;12265;3019;1325;1132;39;57;85;12;1694;1627;67;1153;1218;482;697;25;14
Winschoten;0;0;0;0;0;0;0;0;0;0;0;0;0;0;0;0;0;0
Winsum;0;0;0;0;0;0;0;0;0;0;0;0;0;0;0;0;0;0
Winterswijk;22031;14394;4907;1905;1471;130;216;78;10;3002;2574;428;1200;1530;915;565;37;13
Wisch;0;0;0;0;0;0;0;0;0;0;0;0;0;0;0;0;0;0
Woensdrecht;18215;12374;3287;1363;1132;58;100;67;6;1924;1708;216;1166;1388;646;708;26;8
Woerden;37080;24563;7889;3699;2993;231;344;124;7;4190;3584;606;2050;2578;1249;1261;42;26
Wognum;0;0;0;0;0;0;0;0;0;0;0;0;0;0;0;0;0;0
De Wolden;23683;14156;6293;2558;2114;126;166;140;12;3735;3522;213;1673;1561;753;761;39;8
Wormerland;12613;7927;2282;1028;873;27;67;60;1;1254;1125;129;1005;1399;614;759;19;7
Woudenberg;11159;6620;3121;1271;1008;57;116;68;22;1850;1397;453;638;780;417;346;13;4
Woudrichem;0;0;0;0;0;0;0;0;0;0;0;0;0;0;0;0;0;0
Wûnseradiel;0;0;0;0;0;0;0;0;0;0;0;0;0;0;0;0;0;0
Wymbritseradiel;0;0;0;0;0;0;0;0;0;0;0;0;0;0;0;0;0;0
Zaanstad;102023;65395;15039;7708;6516;299;395;398;100;7331;6665;666;6869;14720;7977;6552;127;64
Zaltbommel;23666;14725;6064;2894;2188;249;350;106;1;3170;2614;556;1033;1844;825;933;76;10
Zandvoort;11924;7854;1166;677;604;15;23;34;1;489;442;47;659;2245;1730;492;16;7
Zederik;0;0;0;0;0;0;0;0;0;0;0;0;0;0;0;0;0;0
Zeevang;0;0;0;0;0;0;0;0;0;0;0;0;0;0;0;0;0;0
Zeewolde;23668;15917;5624;2695;1993;95;542;65;0;2929;1791;1138;1037;1090;538;529;16;7
Zeist;47131;36667;5413;3347;3133;59;26;128;1;2066;2035;31;1908;3143;1679;1397;47;20
Zelhem;0;0;0;0;0;0;0;0;0;0;0;0;0;0;0;0;0;0
Zevenaar;34413;23250;5631;2410;2038;102;121;148;1;3221;2992;229;2233;3299;1976;1249;58;16
Zevenhuizen-Moerkapelle;0;0;0;0;0;0;0;0;0;0;0;0;0;0;0;0;0;0
Zijpe;0;0;0;0;0;0;0;0;0;0;0;0;0;0;0;0;0;0
Zoetermeer;77454;57107;8127;3966;3346;199;116;185;120;4161;3995;166;4094;8126;4498;3553;47;28
Zoeterwoude;7055;4052;1513;837;606;56;78;85;12;676;577;99;454;1036;641;387;7;1
Zuidhorn;0;0;0;0;0;0;0;0;0;0;0;0;0;0;0;0;0;0
Zuidplas;33990;21403;6931;3444;2648;192;407;193;4;3487;3010;477;2122;3534;1927;1570;25;12
Zundert;18945;12402;4421;2143;1751;141;174;73;4;2278;1991;287;938;1184;419;719;31;15
Zutphen;30137;21181;4527;1881;1477;150;52;198;4;2646;2582;64;1648;2781;1922;812;35;12
Zwartewaterland;21073;11086;7139;3170;2471;226;399;74;0;3969;2407;1562;877;1971;894;1049;23;5
Zwartsluis;0;0;0;0;0;0;0;0;0;0;0;0;0;0;0;0;0;0
Zwijndrecht;30631;21405;4647;2258;1886;102;197;73;0;2389;2180;209;1472;3107;2069;992;39;7
Zwolle;79969;54931;12192;5929;4985;215;191;513;25;6263;6010;253;4473;8373;6004;2247;79;43
